*****
*   *
* * *
*   *
*****